x0 y0 z7 e
x1 y0 z7 e
x2 y0 z7 e
x3 y0 z7 e
x4 y0 z7 e
x5 y0 z4 e
x6 y0 z4 e
x7 y0 z4 e
x8 y0 z4 e
x9 y0 z7 e
x0 y1 z7 e
x1 y1 z7 e
x2 y1 z4 e
x3 y1 z4 e
x4 y1 z4 e
x5 y1 z6 e
x6 y1 z6 e
x7 y1 z6 e
x8 y1 z6 e
x9 y1 z4 e
x0 y2 z7 e
x1 y2 z4 e
x2 y2 z6 e
x3 y2 z6 e
x4 y2 z6 e
x5 y2 z3 e
x6 y2 z3 e
x7 y2 z5 e
x8 y2 z6 e
x9 y2 z4 e
x0 y3 z4 e
x1 y3 z6 e
x2 y3 z6 e
x3 y3 z5 e
x4 y3 z5 e
x5 y3 z6 e
x6 y3 z3 e
x7 y3 z3 e
x8 y3 z6 e
x9 y3 z4 e
x0 y4 z4 e
x1 y4 z6 e
x2 y4 z5 e
x3 y4 z5 e
x4 y4 z5 e
x5 y4 z6 e
x6 y4 z3 e
x7 y4 z3 e
x8 y4 z4 e
x9 y4 z3 e
x0 y5 z4 e
x1 y5 z6 e
x2 y5 z5 e
x3 y5 z5 e
x4 y5 z5 e
x5 y5 z6 e
x6 y5 z4 e
x7 y5 z3 e
x8 y5 z3 e
x9 y5 z3 e
x0 y6 z7 e
x1 y6 z4 e
x2 y6 z6 e
x3 y6 z5 e
x4 y6 z6 e
x5 y6 z6 e
x6 y6 z4 e
x7 y6 z3 e
x8 y6 z3 e
x9 y6 z3 e
x0 y7 z7 e
x1 y7 z7 e
x2 y7 z4 e
x3 y7 z6 e
x4 y7 z6 e
x5 y7 z4 e
x6 y7 z7 e
x7 y7 z7 e
x8 y7 z7 e
x9 y7 z3 e
x0 y8 z7 e
x1 y8 z7 e
x2 y8 z7 e
x3 y8 z4 e
x4 y8 z4 e
x5 y8 z7 e
x6 y8 z7 e
x7 y8 z7 e
x8 y8 z2 e
x9 y8 z2 e
x0 y9 z7 e
x1 y9 z7 e
x2 y9 z7 e
x3 y9 z7 e
x4 y9 z7 e
x5 y9 z7 e
x6 y9 z7 e
x7 y9 z2 e
x8 y9 z2 e
x9 y9 z2 e
